111111111111111111111111111111111111
10C0001110101111111100000000000000E1
111100000010001111111111000000111111
111100111110000000000000000000001111
1P0001111100111111110000011111000011
10000000000C111111111110000000011111
111111111111111111111111111111111111