1111111111111111111
1PCE000011111111111
1111111111111111111
