1111111111111111111
1111110011111111111
1111110011111111111
1000000000P00000001
1000000000001111111
1C00000000000000001
1000011111100000001
1111111111111000111
1111111111111E11111
1111111111111111111